18 16 16 16 16 16 16 16 19 20 16 16 16 16 19 20 16 16 16 16 16 16 16 21
11 41 40 40 40 40 40 40 06 08 40 40 40 40 06 08 40 40 40 40 40 40 41 09
11 40 00 01 01 01 02 40 06 08 40 00 02 40 06 08 40 00 02 40 00 02 40 09
11 40 06 07 07 07 08 40 06 08 40 06 08 40 06 08 40 06 08 40 06 08 40 09
11 40 12 13 13 13 14 40 12 14 40 06 08 40 12 14 40 12 14 40 12 14 40 09
11 40 40 40 40 40 40 40 40 40 40 06 08 40 40 40 40 40 40 40 40 40 40 09
11 40 00 02 40 00 02 40 00 01 01 25 26 01 01 02 40 00 02 40 00 02 40 09
11 40 06 08 40 06 08 40 12 13 13 13 13 13 13 14 40 06 08 40 06 08 40 09
11 40 12 14 40 06 08 40 40 40 40 40 40 40 40 40 40 06 08 40 12 14 40 09
11 40 40 40 40 06 08 40 03 04 04 -1 -1 04 04 05 40 06 08 40 40 40 40 09
11 40 00 02 40 06 08 40 09 -4 -3 -2 -2 -3 -4 11 40 06 08 40 00 02 40 09
11 40 06 08 40 12 14 40 09 -4 -3 -3 -3 -3 -4 11 40 12 14 40 06 08 40 09
11 40 06 08 40 40 40 40 09 -4 -4 -4 -4 -4 -4 11 40 40 40 40 06 08 40 09
11 40 12 14 40 00 02 40 09 -5 -5 -5 -5 -5 -5 11 40 00 02 40 12 14 40 09
11 40 40 40 40 06 08 40 15 16 16 16 16 16 16 17 40 06 08 40 40 40 40 09
11 40 00 02 40 06 08 40 40 40 40 99 99 40 40 40 40 06 08 40 00 02 40 09
11 40 06 08 40 06 08 40 00 01 01 01 01 01 01 02 40 06 08 40 06 08 40 09
11 40 12 14 40 12 14 40 12 13 13 31 32 13 13 14 40 12 14 40 12 14 40 09
11 40 40 40 40 40 40 40 40 40 40 06 08 40 40 40 40 40 40 40 40 40 40 09
11 40 00 02 40 00 02 40 00 02 40 06 08 40 00 02 40 00 01 01 01 02 40 09
11 40 06 08 40 06 08 40 06 08 40 06 08 40 06 08 40 06 07 07 07 08 40 09
11 40 12 14 40 12 14 40 06 08 40 12 14 40 06 08 40 12 13 13 13 14 40 09
11 41 40 40 40 40 40 40 06 08 40 40 40 40 06 08 40 40 40 40 40 40 41 09
36 04 04 04 04 04 04 04 25 24 04 04 04 04 25 24 04 04 04 04 04 04 04 37